date,investment,cy_invested,reserve_amt,current,today_pnl_amount,today_pnl_percentage,curr_pnl_amount,curr_pnl_percentage,cy_pnl_amount,cy_pnl_percentage,total_profit,total_loss,overall_pnl_amount,overall_pnl_percentage,total_booked_amt,total_booked_percentage,cy_booked_amt,cy_booked_percentage,py_booked_amt,py_booked_percentage,estimate_st,est_st_pnl_amount,est_st_pnl_percentage,estimate_lt,est_lt_pnl_amount,est_lt_pnl_percentage,cagr
06-12-2024,10102190,11413190,1700,12200238,19948,0.16,-199431,-1.75,760569,6.66,828759,-1028189,2071569,20.51,2271000,22.48,960000,7.87,1311000,12.98,19425149,7224911,59.22,24530839,12330601,101.07,17.61
10-12-2024,10102190,11413190,2500,12283079,80131,0.66,-183516,-1.61,843484,7.39,802490,-986008,2154484,21.33,2338000,23.14,1027000,8.36,1311000,12.98,19441419,7158340,58.28,24575759,12292680,100.08,18.11
11-12-2024,10102190,11413190,2500,12314905,34495,0.28,-151690,-1.33,875310,7.67,837993,-989681,2186310,21.64,2338000,23.14,1027000,8.34,1311000,12.98,19441419,7126514,57.87,24574013,12259108,99.55,18.32
16-12-2024,10102190,11413190,2500,12227280,29403,0.24,-239315,-2.1,787685,6.9,827639,-1066953,2098685,20.77,2338000,23.14,1027000,8.4,1311000,12.98,19441830,7214550,59,24576170,12348890,100.99,17.4
17-12-2024,10102190,11413190,2500,12098044,-131789,-1.08,-368551,-3.23,658449,5.77,762069,-1130618,1969449,19.5,2338000,23.14,1027000,8.49,1311000,12.98,19441419,7343375,60.7,24575046,12477002,103.13,16.33
20-12-2024,10102190,11413190,2500,11675816,-223199,-1.88,-790779,-6.93,236221,2.07,636983,-1427765,1547221,15.32,2338000,23.14,1027000,8.8,1311000,12.98,19441830,7766014,66.51,24571916,12896100,110.45,12.85
21-12-2024,10102190,11413190,2500,11676518,-221905,-1.86,-790077,-6.92,236923,2.08,636443,-1426520,1547923,15.32,2338000,23.14,1027000,8.8,1311000,12.98,19441830,7765312,66.5,24573711,12897193,110.45,12.83
27-12-2024,10302190,11613190,3100,11845645,-177,0,-858744,-7.39,207256,1.78,573180,-1431927,1518256,14.74,2377000,23.07,1066000,9,1311000,12.73,19594291,7748646,65.41,24929116,13083471,110.45,12.4
30-12-2024,10302190,11613190,3100,11778728,-66917,-0.56,-925661,-7.97,140339,1.21,533042,-1458704,1451339,14.09,2377000,23.07,1066000,9.05,1311000,12.73,18927436,7148708,60.69,24712189,12933461,109.8,11.79
31-12-2024,10302190,11613190,3100,11814394,33362,0.28,-889995,-7.66,176005,1.52,554111,-1444108,1487005,14.43,2377000,23.07,1066000,9.02,1311000,12.73,19035673,7221279,61.12,24712189,12897795,109.17,12.04
01-01-2025,10302190,11613190,3100,11950129,135735,1.15,-754260,-6.49,311740,2.68,584764,-1339026,1622740,15.75,2377000,23.07,1066000,8.92,1311000,12.73,19070574,7120445,59.58,24710393,12760264,106.78,13.07
02-01-2025,10302190,11613190,3100,12075972,125843,1.05,-628417,-5.41,437583,3.77,637395,-1265811,1748583,16.97,2377000,23.07,1066000,8.83,1311000,12.73,19070574,6994602,57.92,24708647,12632675,104.61,14
03-01-2025,10392190,11703190,3000,12162743,2527,0.02,-649906,-5.55,437094,3.73,610848,-1260761,1748094,16.82,2398000,23.08,1087000,8.94,1311000,12.62,19209748,7047005,57.94,24776026,12613283,103.7,13.95
06-01-2025,10392190,11703190,3000,11855983,-306760,-2.52,-956666,-8.17,130334,1.11,525337,-1482003,1441334,13.87,2398000,23.08,1087000,9.17,1311000,12.62,18673012,6817029,57.5,24771771,12915788,108.94,11.5
07-01-2025,10392190,11703190,0,11962074,108384,0.91,-914929,-7.82,235071,2.01,480610,-1395540,1546071,14.88,2461000,23.68,1150000,9.61,1311000,12.62,18708116,6746042,56.4,24810448,12848374,107.41,12.29
08-01-2025,10392190,11703190,0,11905854,-56220,-0.47,-971149,-8.3,178851,1.53,459715,-1430865,1489851,14.34,2461000,23.68,1150000,9.66,1311000,12.62,18708116,6802262,57.13,24811161,12905307,108.39,11.83
10-01-2025,10392190,11703190,0,11642800,-207641,-1.75,-1234203,-10.55,-84203,-0.72,408033,-1642237,1226797,11.8,2461000,23.68,1150000,9.88,1311000,12.62,18690893,7048093,60.54,24799634,13156834,113,9.72
13-01-2025,10392190,11703190,0,11271529,-371271,-3.19,-1605474,-13.72,-455474,-3.89,314395,-1919872,855526,8.23,2461000,23.68,1150000,10.2,1311000,12.62,18690893,7419364,65.82,24798942,13527413,120.01,6.84
14-01-2025,10392190,11703190,0,11438357,162234,1.44,-1467919,-12.54,-282919,-2.42,301952,-1769873,1028081,9.89,2496000,24.02,1185000,10.36,1311000,12.62,18648458,7210101,63.03,24753134,13314777,116.4,8.12
16-01-2025,10427190,11738190,0,11585935,117152,1.02,-1355167,-11.54,-165167,-1.41,337448,-1692613,1145833,10.99,2501000,23.99,1190000,10.27,1311000,12.57,18699578,7113643,61.4,24808815,13222880,114.13,8.94
17-01-2025,10427190,11738190,0,11578815,-6730,-0.06,-1362287,-11.61,-172287,-1.47,319559,-1681842,1138713,10.92,2501000,23.99,1190000,10.28,1311000,12.57,18699578,7120763,61.5,24809507,13230692,114.27,8.84
20-01-2025,10427190,11738190,1039000,11658409,53088,0.46,-1419364,-12.09,-94364,-0.8,233075,-1652442,1216636,11.67,2636000,25.28,1325000,11.37,1311000,12.57,18298791,6640382,56.96,24207591,12549182,107.64,9.4
21-01-2025,10427190,11738190,421847,11551802,-112896,-0.97,-1526890,-13.01,-199890,-1.7,197721,-1724612,1111110,10.66,2638000,25.3,1327000,11.49,1311000,12.57,18484782,6932980,60.02,24396372,12844570,111.19,8.58
22-01-2025,10427190,11738190,421847,11488567,-62983,-0.55,-1590125,-13.55,-263125,-2.24,210131,-1800256,1047875,10.05,2638000,25.3,1327000,11.55,1311000,12.57,18484450,6995883,60.89,24396039,12907472,112.35,8.09
23-01-2025,10427190,11738190,421847,11556704,68137,0.59,-1521988,-12.97,-194988,-1.66,242228,-1764213,1116012,10.7,2638000,25.3,1327000,11.48,1311000,12.57,18484450,6927746,59.95,24391785,12835081,111.06,8.58
24-01-2025,10427190,11738190,421847,11420856,-135848,-1.18,-1657836,-14.12,-330836,-2.82,214001,-1871831,980164,9.4,2638000,25.3,1327000,11.62,1311000,12.57,18484450,7063594,61.85,24396039,12975183,113.61,7.54
27-01-2025,10427190,11738190,239000,11162223,-260433,-2.28,-1916611,-16.33,-589611,-5.02,172729,-2089340,721389,6.92,2638000,25.3,1327000,11.89,1311000,12.57,18481925,7319702,65.58,24394745,13232522,118.55,5.57
28-01-2025,10427190,11738190,239000,11143039,-274109,-2.4,-1935795,-16.49,-608795,-5.19,188208,-2124005,702205,6.73,2638000,25.3,1327000,11.91,1311000,12.57,18481925,7338886,65.86,24392560,13249521,118.9,5.41
29-01-2025,10427190,11738190,239000,11321227,180818,1.62,-1757607,-14.97,-430607,-3.67,227105,-1984716,880393,8.44,2638000,25.3,1327000,11.72,1311000,12.57,18481925,7160698,63.25,24390821,13069594,115.44,6.72
30-01-2025,10427190,11738190,731000,11357171,27457,0.24,-1778296,-15.15,-391296,-3.33,184908,-1963199,919704,8.82,2698000,25.87,1387000,12.21,1311000,12.57,18364819,7007648,61.7,24294158,12936987,113.91,6.97
31-01-2025,10427190,11738190,731000,11411639,81925,0.72,-1723828,-14.69,-336828,-2.87,202571,-1926401,974172,9.34,2698000,25.87,1387000,12.15,1311000,12.57,18364819,6953180,60.93,24297700,12886061,112.92,7.36
31-01-2025,10427190,11738190,331000,11509121,169392,1.49,-1630919,-13.89,-243919,-2.08,215582,-1846496,1067081,10.23,2698000,25.87,1387000,12.05,1311000,12.57,18526569,7017448,60.97,24508662,12999541,112.95,8.08
01-02-2025,10427190,11738190,331000,11569458,60337,0.52,-1570582,-13.38,-183582,-1.56,263104,-1833686,1127418,10.81,2698000,25.87,1387000,11.99,1311000,12.57,18526194,6956736,60.13,24506545,12937087,111.82,8.48
03-02-2025,10427190,11738190,331000,11417881,-91171,-0.79,-1722159,-14.67,-335159,-2.86,220417,-1942576,975841,9.36,2698000,25.87,1387000,12.15,1311000,12.57,18526194,7108313,62.26,24504745,13086864,114.62,7.36
04-02-2025,10427190,11738190,123000,11515154,101125,0.89,-1618366,-13.79,-231366,-1.97,258896,-1877262,1079634,10.35,2698000,25.87,1387000,12.04,1311000,12.57,18546889,7031735,61.07,24542743,13027589,113.13,8.05
05-02-2025,10427190,11738190,123000,11563250,48676,0.42,-1570270,-13.38,-183270,-1.56,277582,-1847853,1127730,10.82,2698000,25.87,1387000,11.99,1311000,12.57,18546412,6983162,60.39,24542461,12979211,112.25,8.38
06-02-2025,10427190,11738190,123000,11579452,16202,0.14,-1554068,-13.24,-167068,-1.42,269976,-1824047,1143932,10.97,2698000,25.87,1387000,11.98,1311000,12.57,18546412,6966960,60.17,24538065,12958613,111.91,8.48
07-02-2025,10427190,11738190,123000,11496055,-80083,-0.69,-1637465,-13.95,-250465,-2.13,261078,-1898544,1060535,10.17,2698000,25.87,1387000,12.07,1311000,12.57,18545706,7049651,61.32,24530155,13034100,113.38,7.86
10-02-2025,10427190,11738190,248000,11451715,-169340,-1.46,-1806805,-15.39,-419805,-3.58,220468,-2027272,891195,8.55,2698000,25.87,1387000,12.11,1311000,12.57,18670706,7218991,63.04,24653535,13201820,115.28,7.49
11-02-2025,10652190,11963190,248000,11268533,-283340,-2.45,-2090385,-17.47,-703385,-5.88,178069,-2268455,607615,5.7,2698000,25.33,1387000,12.31,1311000,12.31,18796166,7527633,66.8,24799656,13531123,120.08,4.53
12-02-2025,10652190,11963190,248000,11260804,-9985,-0.09,-2098114,-17.54,-711114,-5.94,185044,-2283159,599886,5.63,2698000,25.33,1387000,12.32,1311000,12.31,18796166,7535362,66.92,24799834,13539030,120.23,4.46
13-02-2025,10652190,11963190,248000,11261097,3031,0.03,-2097821,-17.54,-710821,-5.94,194126,-2291943,600179,5.63,2698000,25.33,1387000,12.32,1311000,12.31,18796166,7535069,66.91,24795912,13534815,120.19,4.45
14-02-2025,10652190,11963190,248000,11061432,-199659,-1.77,-2297486,-19.2,-910486,-7.61,176211,-2473700,400514,3.76,2698000,25.33,1387000,12.54,1311000,12.31,18796158,7734726,69.93,24792714,13731282,124.14,3
18-02-2025,10652190,11963190,148000,10937134,-80307,-0.73,-2422361,-20.25,-1035361,-8.65,183981,-2606347,275639,2.59,2698000,25.33,1387000,12.68,1311000,12.31,18827880,7890746,72.15,24850367,13913233,127.21,2.07
24-02-2025,10652190,11963190,148000,10992938,-115062,-1.04,-2366557,-19.78,-979557,-8.19,175526,-2542080,331443,3.11,2698000,25.33,1387000,12.62,1311000,12.31,18827880,7834942,71.27,24852482,13859544,126.08,2.45
25-02-2025,10652190,11963190,148000,10924857,-69644,-0.63,-2434638,-20.35,-1047638,-8.76,173634,-2608273,263362,2.47,2698000,25.33,1387000,12.7,1311000,12.31,18827880,7903023,72.34,24851676,13926819,127.48,1.96
27-02-2025,10652190,11963190,148000,10830493,-94364,-0.86,-2529002,-21.14,-1142002,-9.55,176214,-2705215,168998,1.59,2698000,25.33,1387000,12.81,1311000,12.31,18827880,7997387,73.84,24855578,14025085,129.5,1.28
28-02-2025,10652190,11963190,148000,10591121,-239372,-2.21,-2768374,-23.14,-1381374,-11.55,145645,-2914020,-70374,-0.66,2698000,25.33,1387000,13.1,1311000,12.31,18827880,8236759,77.77,24848811,14257690,134.62,-0.44
03-03-2025,10652190,11963190,148000,10507296,-83825,-0.79,-2852199,-23.84,-1465199,-12.25,147579,-2999777,-154199,-1.45,2698000,25.33,1387000,13.2,1311000,12.31,18778078,8270782,78.71,24851322,14344026,136.51,-1.03
04-03-2025,10652190,11963190,148000,10534895,27599,0.26,-2824600,-23.61,-1437600,-12.02,156421,-2981020,-126600,-1.19,2698000,25.33,1387000,13.17,1311000,12.31,18778078,8243183,78.25,24848864,14313969,135.87,-0.84
06-03-2025,10652190,11963190,52000,10916815,139764,1.3,-2442233,-20.41,-1055233,-8.82,185718,-2627951,255767,2.4,2698000,25.33,1387000,12.71,1311000,12.31,18894020,7977205,73.07,24922925,14006110,128.3,1.86
07-03-2025,10652190,11963190,52000,10951286,34655,0.32,-2407762,-20.13,-1020762,-8.53,180440,-2588203,290238,2.72,2698000,25.33,1387000,12.67,1311000,12.31,18893771,7942485,72.53,24919865,13968579,127.55,2.1
10-03-2025,10652190,11963190,52000,10782467,-168819,-1.54,-2576581,-21.54,-1189581,-9.94,173832,-2750420,121419,1.14,2698000,25.33,1387000,12.86,1311000,12.31,18893771,8111304,75.23,24918068,14135601,131.1,0.91
11-03-2025,10652190,11963190,52000,10688115,-94352,-0.88,-2670933,-22.33,-1283933,-10.73,161576,-2832509,27067,0.25,2698000,25.33,1387000,12.98,1311000,12.31,18893771,8205656,76.77,24922323,14234208,133.18,0.25
18-03-2025,10604190,11915190,4000,10706567,199101,1.89,-2604481,-21.86,-1217481,-10.22,215537,-2820018,93519,0.88,2698000,25.44,1387000,12.95,1311000,12.36,18845771,8139204,76.02,24871134,14164567,132.3,0.71
19-03-2025,10604190,11915190,4000,10906442,396180,3.77,-2404606,-20.18,-1017606,-8.54,252215,-2656823,293394,2.77,2698000,25.44,1387000,12.72,1311000,12.36,18845771,7939329,72.79,24871009,13964567,128.04,2.07
20-03-2025,10604190,11915190,4000,10981045,75318,0.69,-2330003,-19.55,-943003,-7.91,273049,-2603044,367997,3.47,2698000,25.44,1387000,12.63,1311000,12.36,18845771,7864726,71.62,24872620,13891575,126.51,2.57
21-03-2025,10604190,11915190,4000,11139557,162031,1.48,-2171491,-18.22,-784491,-6.58,313108,-2484601,526509,4.97,2698000,25.44,1387000,12.45,1311000,12.36,18845771,7706214,69.18,24867704,13728147,123.24,3.64
24-03-2025,10604190,11915190,4000,11269073,129516,1.16,-2041975,-17.14,-654975,-5.5,347201,-2389172,656025,6.19,2698000,25.44,1387000,12.31,1311000,12.36,18845771,7576698,67.23,24860824,13591751,120.61,4.48
25-03-2025,10604190,11915190,4000,11127728,-141345,-1.25,-2183320,-18.32,-796320,-6.68,324772,-2508088,514680,4.85,2698000,25.44,1387000,12.46,1311000,12.36,18845771,7718043,69.36,24860771,13733043,123.41,3.53
26-03-2025,10604190,11915190,4000,11024887,-102841,-0.92,-2286161,-19.19,-899161,-7.55,310115,-2596276,411839,3.88,2698000,25.44,1387000,12.58,1311000,12.36,18845771,7820884,70.94,24862375,13837488,125.51,2.83
27-03-2025,10604190,11915190,4000,11068367,43480,0.39,-2242681,-18.82,-855681,-7.18,339106,-2581783,455319,4.29,2698000,25.44,1387000,12.53,1311000,12.36,18845771,7777404,70.27,24867651,13799284,124.67,3.12
28-03-2025,10604190,11915190,4000,11004653,-63714,-0.58,-2306395,-19.36,-919395,-7.72,343890,-2650283,391605,3.69,2698000,25.44,1387000,12.6,1311000,12.36,18845771,7841118,71.25,24866825,13862172,125.97,2.68
01-04-2025,10604190,11915190,4000,11067059,62406,0.57,-2243989,-18.83,-856989,-7.19,308058,-2552049,454011,4.28,2698000,25.44,1387000,12.53,1311000,12.36,18845771,7778712,70.29,24862517,13795458,124.65,3.08
02-04-2025,10904190,12215190,300000,11456791,93732,0.82,-2150257,-17.6,-763257,-6.25,351627,-2501885,547743,5.02,2698000,24.74,1387000,12.11,1311000,12.02,19141771,7684980,67.08,25162629,13705838,119.63,3.66
03-04-2025,10904190,12215190,300000,11531934,75143,0.66,-2075114,-16.99,-688114,-5.63,371121,-2446239,622886,5.71,2698000,24.74,1387000,12.03,1311000,12.02,19141771,7609837,65.99,25165592,13633658,118.23,4.15
04-04-2025,10904190,13602190,0,11250806,-281369,-2.44,-2356964,-17.33,-2356964,-17.33,297967,-2654930,341036,3.13,2698000,24.74,0,0,2698000,24.74,19335092,8084286,71.86,25448071,14197265,126.19,2.29
07-04-2025,10904190,13602190,0,10865023,-385783,-3.43,-2742747,-20.16,-2742747,-20.16,218564,-2961313,-44747,-0.41,2698000,24.74,0,0,2698000,24.74,19335092,8470069,77.96,25448164,14583141,134.22,-0.26
08-04-2025,10904190,13602190,0,11121374,256351,2.36,-2486396,-18.28,-2486396,-18.28,285734,-2772128,211604,1.94,2698000,24.74,0,0,2698000,24.74,19335092,8213718,73.86,25451673,14330299,128.85,1.43
09-04-2025,10904190,13602190,4000,11081730,-38186,-0.34,-2542065,-18.69,-2528565,-18.59,272114,-2814185,169435,1.55,2711500,24.87,13500,0.12,2698000,24.74,19372309,8290579,74.81,25489769,14408039,130.02,1.17
11-04-2025,10904190,13602190,213000,11241467,169413,1.53,-2397055,-17.62,-2368181,-17.41,286952,-2684008,329819,3.02,2726874,25.01,28874,0.26,2698000,24.74,19332213,8090746,71.97,25353286,14111819,125.53,2.2
15-04-2025,10904190,13602190,213000,11445802,204335,1.82,-2192720,-16.12,-2163846,-15.91,366074,-2558793,534154,4.9,2726874,25.01,28874,0.25,2698000,24.74,19332213,7886411,68.9,25352623,13906821,121.5,3.5
16-04-2025,10904190,13602190,213000,11548267,102465,0.9,-2090255,-15.37,-2061381,-15.15,417983,-2508235,636619,5.84,2726874,25.01,28874,0.25,2698000,24.74,19332213,7783946,67.4,25356796,13808529,119.57,4.14
17-04-2025,10904190,13602190,3000,11637687,119639,1.04,-1972084,-14.5,-1943210,-14.29,475343,-2447428,754790,6.92,2726874,25.01,28874,0.25,2698000,24.74,19394425,7756738,66.65,25417030,13779343,118.4,4.68
21-04-2025,10904190,13602190,3000,11800988,163301,1.4,-1808783,-13.3,-1779909,-13.09,519098,-2327880,918091,8.42,2726874,25.01,28874,0.24,2698000,24.74,19394425,7593437,64.35,25411960,13610972,115.34,5.68
22-04-2025,10904190,13602190,3000,11878927,77939,0.66,-1730844,-12.72,-1701970,-12.51,554541,-2285380,996030,9.13,2726874,25.01,28874,0.24,2698000,24.74,19394425,7515498,63.27,25410133,13531206,113.91,6.16
23-04-2025,11004190,13702190,2000,11915211,44057,0.37,-1812079,-13.22,-1658408,-12.1,439011,-2251091,1039592,9.45,2851671,25.91,153671,1.29,2698000,24.52,19606080,7690869,64.55,25650989,13735778,115.28,5.75
24-04-2025,11004190,13702190,2000,11934336,19125,0.16,-1792954,-13.09,-1639283,-11.96,430266,-2223223,1058717,9.62,2851671,25.91,153671,1.29,2698000,24.52,19606080,7671744,64.28,25656919,13722583,114.98,5.86
25-04-2025,11004190,13702190,2000,11670827,-263509,-2.21,-2056463,-15.01,-1902792,-13.89,354636,-2411097,795208,7.23,2851671,25.91,153671,1.32,2698000,24.52,19606080,7935253,67.99,25655244,13984417,119.82,4.21
28-04-2025,11004190,13702190,2000,11758583,87756,0.75,-1968707,-14.37,-1815036,-13.25,405331,-2374039,882964,8.02,2851671,25.91,153671,1.31,2698000,24.52,19606080,7847497,66.74,25657868,13899285,118.21,4.73
29-04-2025,11004190,13702190,2000,11781366,22783,0.19,-1945924,-14.2,-1792253,-13.08,421484,-2367408,905747,8.23,2851671,25.91,153671,1.3,2698000,24.52,19606080,7824714,66.42,25652724,13871358,117.74,4.86
30-04-2025,11004190,13702190,228223,11664195,-116248,-0.99,-2111466,-15.41,-1910069,-13.94,358063,-2469534,787931,7.16,2899397,26.35,201397,1.73,2698000,24.52,19541150,7876955,67.53,25589365,13925170,119.38,4.13
02-05-2025,11404190,14102190,478223,12166675,-26345,-0.22,-2107012,-14.94,-1905615,-13.51,349292,-2456301,792385,6.95,2899397,25.42,201397,1.66,2698000,23.66,20252439,8085764,66.46,26322358,14155683,116.35,4.74
05-05-2025,11404190,14102190,478223,12287513,137546,1.13,-1986174,-14.08,-1784777,-12.66,384859,-2371035,913223,8.01,2899397,25.42,201397,1.64,2698000,23.66,20252439,7964926,64.82,26328121,14040608,114.27,5.45
07-05-2025,11404190,14102190,631000,12338973,77791,0.63,-2212204,-15.69,-1928807,-13.68,288954,-2501159,769193,6.74,2981397,26.14,283397,2.3,2698000,23.66,20470954,8131981,65.9,26581064,14242091,115.42,5.74
08-05-2025,11404190,14102190,631000,12207440,-131533,-1.07,-2343737,-16.62,-2060340,-14.61,265984,-2609721,637660,5.59,2981397,26.14,283397,2.32,2698000,23.66,20470954,8263514,67.69,26586328,14378888,117.79,4.92
09-05-2025,11404190,14102190,377782,12162820,-47974,-0.39,-2396888,-17,-2113491,-14.99,249079,-2645971,584509,5.13,2981397,26.14,283397,2.33,2698000,23.66,20670367,8507547,69.95,26848304,14685484,120.74,4.65
12-05-2025,11404190,14102190,402782,12638731,467234,3.84,-1927484,-13.67,-1640587,-11.63,384950,-2312432,1057413,9.27,2984897,26.17,286897,2.27,2698000,23.66,20754154,8115423,64.21,26921781,14283050,113.01,7.46
13-05-2025,11404190,14102190,402782,12673643,34912,0.28,-1892572,-13.42,-1605675,-11.39,373092,-2265666,1092325,9.58,2984897,26.17,286897,2.26,2698000,23.66,20754154,8080511,63.76,26924561,14250918,112.45,7.63
14-05-2025,11404190,14102190,220782,12554688,104284,0.84,-1808064,-12.82,-1521167,-10.79,372599,-2180664,1176833,10.32,2984897,26.17,286897,2.29,2698000,23.66,20611904,8057216,64.18,26762690,14208002,113.17,6.93
15-05-2025,11404190,14102190,220782,12670753,116065,0.92,-1691999,-12,-1405102,-9.96,419000,-2111003,1292898,11.34,2984897,26.17,286897,2.26,2698000,23.66,20611790,7941037,62.67,26762449,14091696,111.21,7.6
16-05-2025,11404190,14102190,210782,12809394,142620,1.13,-1579494,-11.2,-1266597,-8.98,432409,-2011895,1431403,12.55,3010897,26.4,312897,2.44,2698000,23.66,20659886,7850492,61.29,26808533,13999139,109.29,8.39
19-05-2025,11404190,14102190,55893,12840732,36451,0.28,-1543728,-10.95,-1227812,-8.71,443786,-1987510,1470188,12.89,3013916,26.43,315916,2.46,2698000,23.66,20694607,7853875,61.16,26843667,14002935,109.05,8.53
20-05-2025,11404190,14102190,55893,12696162,-144570,-1.13,-1688298,-11.97,-1372382,-9.73,421493,-2109796,1325618,11.62,3013916,26.43,315916,2.49,2698000,23.66,20694493,7998331,63,26845165,14149003,111.44,7.68
21-05-2025,11404190,14102190,294279,12781729,85246,0.67,-1645677,-11.67,-1286458,-9.12,407050,-2052728,1411542,12.38,3057219,26.81,359219,2.81,2698000,23.66,20660368,7878639,61.64,26789665,14007936,109.59,8.15
22-05-2025,11404190,14102190,195090,12728948,-50283,-0.39,-1722489,-12.21,-1336270,-9.48,365440,-2087926,1361730,11.94,3084219,27.04,386219,3.03,2698000,23.66,20778302,8049354,63.24,26900243,14171295,111.33,7.83
23-05-2025,11404190,14102190,499000,12808733,78054,0.61,-1688414,-11.97,-1259195,-8.93,360342,-2048759,1438805,12.62,3127219,27.42,429219,3.35,2698000,23.66,20672264,7863531,61.39,26788139,13979406,109.14,8.28
27-05-2025,11404190,14102190,187000,12935080,37109,0.29,-1639973,-11.63,-1210754,-8.59,379396,-2019367,1487246,13.04,3127219,27.42,429219,3.32,2698000,23.66,20873077,7937997,61.37,27003498,14068418,108.76,8.93
28-05-2025,11654190,14352190,537000,13196130,13601,0.1,-1645119,-11.46,-1198900,-8.35,378093,-2023208,1499100,12.86,3144219,26.98,446219,3.38,2698000,23.15,21116054,7919924,60.02,27238890,14042760,106.42,8.97
29-05-2025,11654190,14352190,423930,13226262,30536,0.23,-1614686,-11.25,-1167411,-8.13,394842,-2009527,1530589,13.13,3145275,26.99,447275,3.38,2698000,23.15,21156285,7930023,59.96,27285720,14059458,106.3,9.13
30-05-2025,11654190,14352190,423930,13205400,-17364,-0.13,-1635548,-11.4,-1188273,-8.28,402194,-2037746,1509727,12.95,3145275,26.99,447275,3.39,2698000,23.15,21156285,7950885,60.21,27285369,14079969,106.62,8.99
02-06-2025,11654190,14352190,393167,13252993,48049,0.36,-1587324,-11.06,-1140049,-7.94,434709,-2022037,1557951,13.37,3145275,26.99,447275,3.37,2698000,23.15,21171823,7918830,59.75,27300134,14047141,105.99,9.21
03-06-2025,11654190,14352190,103167,13151575,-72312,-0.55,-1658927,-11.56,-1211652,-8.44,421400,-2080327,1486348,12.75,3145275,26.99,447275,3.4,2698000,23.15,21120652,7969077,60.59,27349633,14198058,107.96,8.62
04-06-2025,11654190,14352190,103167,13193928,46451,0.35,-1616574,-11.26,-1169299,-8.15,445261,-2061836,1528701,13.12,3145275,26.99,447275,3.39,2698000,23.15,21120652,7926724,60.08,27343469,14149541,107.24,8.84
05-06-2025,11654190,14352190,164167,13227518,33106,0.25,-1634733,-11.39,-1135496,-7.91,433196,-2067922,1562504,13.41,3197237,27.43,499237,3.77,2698000,23.15,21157660,7930142,59.95,27378671,14151153,106.98,9.01
09-06-2025,11654190,14352190,100718,13499420,166560,1.25,-1472402,-10.26,-864228,-6.02,398427,-1870838,1833772,15.73,3306174,28.37,608174,4.51,2698000,23.15,20755973,7256553,53.75,27381340,13881920,102.83,10.43
10-06-2025,11654190,14352190,416352,13572479,74407,0.55,-1399342,-9.75,-791168,-5.51,394201,-1793546,1906832,16.36,3306174,28.37,608174,4.48,2698000,23.15,20523523,6951044,51.21,26818355,13245876,97.59,10.81
11-06-2025,11654190,14352190,416352,13590872,19443,0.14,-1380949,-9.62,-772775,-5.38,397257,-1778210,1925225,16.52,3306174,28.37,608174,4.47,2698000,23.15,20522456,6931584,51,26811960,13221088,97.28,10.89
12-06-2025,11654190,14352190,350476,13436831,-149302,-1.1,-1560429,-10.87,-923429,-6.43,316948,-1877376,1774571,15.23,3335000,28.62,637000,4.74,2698000,23.15,20585456,7148625,53.2,26850245,13413414,99.83,10.03
13-06-2025,11654190,14352190,350476,13330673,-105113,-0.78,-1666587,-11.61,-1029587,-7.17,291250,-1957835,1668413,14.32,3335000,28.62,637000,4.78,2698000,23.15,20585814,7255141,54.42,26844388,13513715,101.37,9.44
16-06-2025,11654190,14352190,150476,13325492,42221,0.32,-1595068,-11.11,-958068,-6.68,326351,-1921416,1739932,14.93,3335000,28.62,637000,4.78,2698000,23.15,20532975,7207483,54.09,26782512,13457020,100.99,9.35
17-06-2025,11654190,14352190,150476,13255476,-68016,-0.51,-1665084,-11.6,-1028084,-7.16,303351,-1968438,1669916,14.33,3335000,28.62,637000,4.81,2698000,23.15,20528748,7273272,54.87,26783004,13527528,102.05,8.96
18-06-2025,11654190,14352190,150476,13227447,-28029,-0.21,-1693113,-11.8,-1056113,-7.36,299929,-1993041,1641887,14.09,3335000,28.62,637000,4.82,2698000,23.15,20529003,7301556,55.2,26780998,13553551,102.47,8.79
20-06-2025,11654190,14352190,35470,13135193,104158,0.8,-1785297,-12.44,-1148297,-8,301929,-2087220,1549703,13.3,3335000,28.62,637000,4.85,2698000,23.15,20566595,7431402,56.58,26934033,13798840,105.05,8.26
23-06-2025,11654190,14352190,35470,13144386,13006,0.1,-1776104,-12.38,-1139104,-7.94,297171,-2073278,1558896,13.38,3335000,28.62,637000,4.85,2698000,23.15,20565534,7421148,56.46,26931659,13787273,104.89,8.26
24-06-2025,11654190,14352190,35470,13236792,92836,0.71,-1683698,-11.73,-1046698,-7.29,303009,-1986710,1651302,14.17,3335000,28.62,637000,4.81,2698000,23.15,20566657,7329865,55.37,26928677,13691885,103.44,8.74
25-06-2025,11654190,14352190,6470,13365194,130492,0.99,-1566405,-10.91,-917405,-6.39,325868,-1892272,1780595,15.28,3347000,28.72,649000,4.86,2698000,23.15,20619283,7254089,54.28,26958077,13592883,101.7,9.41
26-06-2025,11654190,14352190,6470,13402149,36955,0.28,-1529450,-10.66,-880450,-6.13,366771,-1896225,1817550,15.6,3347000,28.72,649000,4.84,2698000,23.15,20619283,7217134,53.85,26961952,13559803,101.18,9.59
27-06-2025,11654190,14352190,6470,13429752,25353,0.19,-1525708,-10.63,-851708,-5.93,359947,-1885655,1846292,15.84,3372000,28.93,674000,5.02,2698000,23.15,20687266,7257514,54.04,27019442,13589690,101.19,9.72
30-06-2025,11654190,14352190,6470,13636312,72638,0.54,-1353597,-9.43,-679597,-4.74,441358,-1794951,2018403,17.32,3372000,28.93,674000,4.94,2698000,23.15,20831985,7195673,52.77,27162017,13525705,99.19,10.74
01-07-2025,11654190,14352190,6470,13637746,2279,0.02,-1352163,-9.42,-678163,-4.73,451819,-1803981,2019837,17.33,3372000,28.93,674000,4.94,2698000,23.15,20831583,7193837,52.75,27163379,13525633,99.18,10.73
02-07-2025,11654190,14352190,6470,13631368,-6378,-0.05,-1358541,-9.47,-684541,-4.77,459019,-1817557,2013459,17.28,3372000,28.93,674000,4.94,2698000,23.15,20831934,7200566,52.82,27166318,13534950,99.29,10.68
03-07-2025,11654190,14352190,6470,13654361,22993,0.17,-1335548,-9.31,-661548,-4.61,466481,-1802030,2036452,17.47,3372000,28.93,674000,4.94,2698000,23.15,20833404,7179043,52.58,27167676,13513315,98.97,10.78
04-07-2025,11654190,14352190,9000,13674074,23187,0.17,-1337748,-9.32,-641748,-4.47,445795,-1783540,2056252,17.64,3394000,29.12,696000,5.09,2698000,23.15,20856559,7182485,52.53,27049970,13375896,97.82,10.86
07-07-2025,11654190,14352190,9000,13697444,23370,0.17,-1314378,-9.16,-618378,-4.31,476825,-1791203,2079622,17.84,3394000,29.12,696000,5.08,2698000,23.15,20858684,7161240,52.28,27048081,13350637,97.47,10.92
08-07-2025,11654190,14352190,9000,13691818,-5626,-0.04,-1320004,-9.2,-624004,-4.35,469778,-1789785,2073996,17.8,3394000,29.12,696000,5.08,2698000,23.15,20862216,7170398,52.37,27067900,13376082,97.69,10.87
09-07-2025,11654190,14352190,9000,13712108,22306,0.16,-1299714,-9.06,-603714,-4.21,494087,-1793802,2094286,17.97,3394000,29.12,696000,5.08,2698000,23.15,20860809,7148701,52.13,27055226,13343118,97.31,10.95
10-07-2025,11654190,14352190,9000,13713042,934,0.01,-1298780,-9.05,-602780,-4.2,483969,-1782748,2095220,17.98,3394000,29.12,696000,5.08,2698000,23.15,20861214,7148172,52.13,27058624,13345582,97.32,10.94
11-07-2025,11654190,14352190,9000,13611908,-109416,-0.8,-1439830,-10.03,-702830,-4.9,431060,-1870894,1995170,17.12,3435000,29.47,737000,5.41,2698000,23.15,20884547,7272639,53.43,26276011,12664103,93.04,10.4
14-07-2025,11654190,14352190,9000,13622573,10665,0.08,-1429165,-9.96,-692165,-4.82,430469,-1859637,2005835,17.21,3435000,29.47,737000,5.41,2698000,23.15,20880769,7258196,53.28,26270040,12647467,92.84,10.4
15-07-2025,11654190,14352190,9000,13736169,114978,0.84,-1315569,-9.17,-578569,-4.03,468073,-1783645,2119431,18.19,3435000,29.47,737000,5.37,2698000,23.15,20884628,7148459,52.04,26272151,12535982,91.26,10.94
16-07-2025,11654190,14352190,161244,13824694,92862,0.68,-1290539,-8.99,-482539,-3.36,423980,-1714519,2215461,19.01,3506000,30.08,808000,5.84,2698000,23.15,20879688,7054994,51.03,26235323,12410629,89.77,11.38
17-07-2025,11654190,14352190,10000,13840922,14041,0.1,-1276133,-8.89,-468133,-3.26,418213,-1694345,2229867,19.13,3506000,30.08,808000,5.84,2698000,23.15,20946226,7105304,51.34,26329076,12488154,90.23,11.44
18-07-2025,11654190,14352190,10000,13773154,-61973,-0.45,-1343901,-9.36,-535901,-3.73,406284,-1750187,2162099,18.55,3506000,30.08,808000,5.87,2698000,23.15,20939933,7166779,52.03,26308692,12535538,91.01,11.06
21-07-2025,11654190,14352190,10000,13745354,-27800,-0.2,-1371701,-9.56,-563701,-3.93,395174,-1766874,2134299,18.31,3506000,30.08,808000,5.88,2698000,23.15,20944577,7199223,52.38,26315039,12569685,91.45,10.88
22-07-2025,11654190,14352190,10000,13672838,-72516,-0.53,-1444217,-10.06,-636217,-4.43,367308,-1811527,2061783,17.69,3506000,30.08,808000,5.91,2698000,23.15,20941925,7269087,53.16,26306837,12633999,92.4,10.5
23-07-2025,11654190,14352190,10000,13715815,43175,0.32,-1401240,-9.76,-593240,-4.13,379241,-1780475,2104760,18.06,3506000,30.08,808000,5.89,2698000,23.15,20941449,7225634,52.68,26306362,12590547,91.8,10.7
24-07-2025,11654190,14352190,10000,13649217,-64323,-0.47,-1467838,-10.23,-659838,-4.6,356446,-1824285,2038162,17.49,3506000,30.08,808000,5.92,2698000,23.15,20938300,7289083,53.4,26303213,12653996,92.71,10.35
25-07-2025,11654190,14352190,10000,13422757,-221059,-1.62,-1694298,-11.81,-886298,-6.18,279511,-1973811,1811702,15.55,3506000,30.08,808000,6.02,2698000,23.15,20938300,7515543,55.99,26291684,12868927,95.87,9.2
28-07-2025,11654190,14352190,10000,13286395,-133262,-0.99,-1830660,-12.76,-1022660,-7.13,255339,-2085998,1675340,14.38,3506000,30.08,808000,6.08,2698000,23.15,20938300,7651905,57.59,26287511,13001116,97.85,8.47
29-07-2025,11654190,14352190,10000,13398019,111624,0.84,-1719036,-11.98,-911036,-6.35,295997,-2015035,1786964,15.33,3506000,30.08,808000,6.03,2698000,23.15,20938300,7540281,56.28,26287511,12889492,96.2,9.01
30-07-2025,12004190,14702190,360000,13771826,23807,0.17,-1695229,-11.53,-887229,-6.03,321789,-2017014,1810771,15.08,3506000,29.21,808000,5.87,2698000,22.48,21289555,7517729,54.59,26638766,12866940,93.43,9.12
31-07-2025,12004190,14702190,451000,13697247,-74440,-0.54,-1765492,-12.01,-962492,-6.55,322252,-2087744,1735508,14.46,3501000,29.16,803000,5.86,2698000,22.48,21285475,7588228,55.4,26584305,12887058,94.09,8.73
01-08-2025,12004190,14702190,353320,13565615,-126721,-0.93,-1921563,-13.07,-1094563,-7.44,228701,-2150259,1603437,13.36,3525000,29.36,827000,6.1,2698000,22.48,21319622,7754007,57.16,26615760,13050145,96.2,8.06
04-08-2025,12004190,14702190,353320,13630910,67995,0.5,-1856268,-12.63,-1029268,-7,255682,-2111947,1668732,13.9,3525000,29.36,827000,6.07,2698000,22.48,21398018,7767108,56.98,26612758,12981848,95.24,8.34
05-08-2025,12004190,14702190,353320,13600400,-28971,-0.21,-1886778,-12.83,-1059778,-7.21,238278,-2125058,1638222,13.65,3525000,29.36,827000,6.08,2698000,22.48,21398018,7797618,57.33,26610851,13010451,95.66,8.17
06-08-2025,12004190,14702190,353320,13494838,-103119,-0.76,-1992340,-13.55,-1165340,-7.93,218224,-2210567,1532660,12.77,3525000,29.36,827000,6.13,2698000,22.48,21395269,7900431,58.54,26607578,13112740,97.17,7.64
07-08-2025,12004190,14702190,353320,13481478,-11181,-0.08,-2005700,-13.64,-1178700,-8.02,227487,-2233185,1519300,12.66,3525000,29.36,827000,6.13,2698000,22.48,21395269,7913791,58.7,26603855,13122377,97.34,7.56
08-08-2025,12004190,14702190,251320,13227744,-121117,-0.91,-2259934,-15.37,-1432934,-9.75,193724,-2453660,1265066,10.54,3525000,29.36,827000,6.25,2698000,22.48,21435291,8207547,62.05,26477004,13249260,100.16,6.28
11-08-2025,12004190,14702190,251320,13246798,19104,0.14,-2240880,-15.24,-1413880,-9.62,220765,-2461646,1284120,10.7,3525000,29.36,827000,6.24,2698000,22.48,21435218,8188420,61.81,26476931,13230133,99.87,6.34
12-08-2025,12004190,14702190,251320,13245824,-974,-0.01,-2241854,-15.25,-1414854,-9.62,217340,-2459196,1283146,10.69,3525000,29.36,827000,6.24,2698000,22.48,21435218,8189394,61.83,26477952,13232128,99.9,6.33
13-08-2025,12004190,14702190,251320,13309989,64165,0.48,-2177689,-14.81,-1350689,-9.19,258503,-2436192,1347311,11.22,3525000,29.36,827000,6.21,2698000,22.48,21435218,8125229,61.05,26477282,13167293,98.93,6.63
14-08-2025,12004190,14702190,251320,13408768,-25575,-0.19,-2078910,-14.14,-1251910,-8.52,260687,-2339596,1446090,12.05,3525000,29.36,827000,6.17,2698000,22.48,21435101,8026333,59.86,26620240,13211472,98.53,7.11
18-08-2025,12004190,14702190,101320,13625189,216653,1.62,-1862421,-12.67,-1035421,-7.04,345628,-2208052,1662579,13.85,3525000,29.36,827000,6.07,2698000,22.48,21449629,7824440,57.43,26655508,13030319,95.63,8.11
19-08-2025,12004190,14702190,101320,13754781,129812,0.95,-1732829,-11.79,-905829,-6.16,380730,-2113557,1792171,14.93,3525000,29.36,827000,6.01,2698000,22.48,21449629,7694848,55.94,26656210,12901429,93.8,8.72
20-08-2025,12004190,14702190,338992,13840532,78355,0.57,-1691730,-11.51,-818730,-5.57,392105,-2083830,1879270,15.66,3571000,29.75,873000,6.31,2698000,22.48,21446241,7605709,54.95,26616800,12776268,92.31,9.11
21-08-2025,12004190,14702190,338992,13800927,-37316,-0.27,-1731335,-11.78,-858335,-5.84,373935,-2105269,1839665,15.33,3571000,29.75,873000,6.33,2698000,22.48,21443744,7642817,55.38,26609781,12808854,92.81,8.91
22-08-2025,12004190,14702190,338992,13707526,-92650,-0.67,-1824736,-12.41,-951736,-6.47,345976,-2170711,1746264,14.55,3571000,29.75,873000,6.37,2698000,22.48,21443744,7736218,56.44,26608539,12901013,94.12,8.45
25-08-2025,12004190,14702190,338992,13719477,12946,0.09,-1812785,-12.33,-939785,-6.39,354794,-2167581,1758215,14.65,3571000,29.75,873000,6.36,2698000,22.48,21443744,7724267,56.3,26606278,12886801,93.93,8.46
26-08-2025,12169190,14867190,899677,13736723,-152264,-1.1,-1988132,-13.37,-1084132,-7.29,299179,-2287307,1613868,13.26,3602000,29.6,904000,6.58,2698000,22.17,21564044,7827321,56.98,26700450,12963727,94.37,7.74
28-08-2025,12169190,14867190,899677,13640460,-96263,-0.7,-2084395,-14.02,-1180395,-7.94,266941,-2351334,1517605,12.47,3602000,29.6,904000,6.63,2698000,22.17,21564044,7923584,58.09,26698416,13057956,95.73,7.26
29-08-2025,12169190,14867190,427658,13656607,20441,0.15,-2067070,-13.9,-1163070,-7.82,260237,-2327300,1534930,12.61,3602000,29.6,904000,6.62,2698000,22.17,21861768,8205161,60.08,27012390,13355783,97.8,7.32
01-09-2025,12169190,14867190,217216,13835183,177295,1.3,-1888418,-12.7,-984418,-6.62,318598,-2207022,1713582,14.08,3602000,29.6,904000,6.53,2698000,22.17,21890474,8055291,58.22,27050556,13215373,95.52,8.13
02-09-2025,12169190,14867190,217216,13920159,84976,0.61,-1803442,-12.13,-899442,-6.05,342470,-2145913,1798558,14.78,3602000,29.6,904000,6.49,2698000,22.17,21890474,7970315,57.26,27050557,13130398,94.33,8.51
03-09-2025,12169190,14867190,500436,14001983,75243,0.54,-1774326,-11.93,-817518,-5.5,311623,-2085949,1880482,15.45,3654808,30.03,956808,6.83,2698000,22.17,21880356,7878373,56.27,27040378,13038395,93.12,8.88
04-09-2025,12169190,14867190,727318,13988802,-27375,-0.2,-1816294,-12.22,-830486,-5.59,292115,-2108407,1867514,15.35,3683808,30.27,985808,7.05,2698000,22.17,21877838,7889036,56.4,27037158,13048356,93.28,8.8
05-09-2025,12169190,14867190,727318,13967567,-21235,-0.15,-1837529,-12.36,-851721,-5.73,287050,-2124579,1846279,15.17,3683808,30.27,985808,7.06,2698000,22.17,21876496,7908929,56.62,27034484,13066917,93.55,8.69
08-09-2025,12169190,14867190,527208,13978040,22245,0.16,-1817952,-12.23,-832144,-5.6,275965,-2093916,1865856,15.33,3683808,30.27,985808,7.05,2698000,22.17,21925092,7947052,56.85,27143099,13165059,94.18,8.69
09-09-2025,12169190,14867190,1103661,14039687,50743,0.36,-1882427,-12.66,-779497,-5.24,171660,-2054081,1918503,15.77,3800930,31.23,1102930,7.86,2698000,22.17,21886957,7847270,55.89,27091871,13052184,92.97,8.96
10-09-2025,12169190,14867190,1103661,14131080,91563,0.65,-1791034,-12.05,-688104,-4.63,203084,-1994123,2009896,16.52,3800930,31.23,1102930,7.8,2698000,22.17,21886957,7755877,54.89,27094853,12963773,91.74,9.37
11-09-2025,12169190,14867190,418212,14147695,20220,0.14,-1771905,-11.92,-668975,-4.5,203358,-1975259,2029025,16.67,3800930,31.23,1102930,7.8,2698000,22.17,22530050,8382355,59.25,28193256,14045561,99.28,9.43
12-09-2025,12169190,14867190,418212,14157568,9923,0.07,-1762032,-11.85,-659102,-4.43,211734,-1973760,2038898,16.75,3800930,31.23,1102930,7.79,2698000,22.17,22529975,8372407,59.14,28196555,14038987,99.16,9.44
